ぜろしきすいじょうていさつき	零式水上偵察機	固有名詞
ぜろてい	零偵	短縮よみ
ぜろしきすいじょうかんそくき	零式水上観測機	固有名詞
ぜろかん	零観	短縮よみ
ずいうん	瑞雲	固有名詞
せいらん	晴嵐	固有名詞
しうん	紫雲	固有名詞
きょうふう	強風	固有名詞
ぜろしきかんせん	零式艦戦	固有名詞
ぜろせん	零戦	短縮よみ
れっぷう	烈風	固有名詞
しでん	紫電	固有名詞
しんでん	震電	固有名詞
すいせい	彗星	固有名詞
なんざん	南山	固有名詞
てんざん	天山	固有名詞
りゅうせい	流星	固有名詞
そーどふぃっしゅ	Swordfish	固有名詞
さいうん	彩雲	固有名詞
けいうん	景雲	固有名詞
きっか	橘花	固有名詞
かたりな	PBY-5A Catalina	固有名詞
にしきだいてい	二式大艇	固有名詞
ぎんが	銀河	固有名詞
とうかい	東海	固有名詞
はやて	疾風	固有名詞
らいでん	雷電	固有名詞
しゅうすい	秋水	固有名詞
ひえん	飛燕	固有名詞
かごうかんそくき	カ号観測機	固有名詞
こうひょうてき	甲標的	固有名詞
さんしきだん	三式弾	固有名詞
だいはつどうてい	大発動艇	固有名詞
ないかてい	内火艇	名詞
かんていしゅうりしせつ	艦艇修理施設	名詞
かんたいしれいぶしせつ	艦隊司令部施設	名詞
おうきゅうしゅうりよういん	応急修理要員	名詞
おうきゅうしゅうりめがみ	応急修理女神	名詞
