こころゆさぶるとしでんせつ	心揺さぶる都市伝説	名詞
げんそうきょうふしぎはっけん	幻想郷ふしぎ発見	名詞
ぼーるのあるにちじょう	ボールのある日常	名詞
けんげんしたでんしょうのかたち	顕現した伝承の形	名詞
じだいのかぜのながれ	時代の風の訪れ	名詞
かちがわからない	価値がわからない	名詞
かのうせいのしんじて	可能性を信じて	名詞
しんじつをしるもの	真実を知る者	名詞
がいかいふぉーくろあ	外界フォークロア	名詞
おのおののけつまつ	各々の結末	名詞
あかされるしんぴ	明かされる深秘	名詞
おかるとあらかると	オカルトアラカルト	名詞
しっぽうしゅうしゅうしょうだうん	七玉蒐集ショウダウン	名詞
こうせいなるうばいあい	公正なる奪い合い	名詞
たいせいちのかね	対蹠地の鐘	名詞
たいしょちのかね	対蹠地の鐘	名詞
ちくりんいんふれいむ	竹林インフレイム	名詞
はなざまのばとるふぃーるど	華狭間のバトルフィールド	名詞
らすとおかるてぃずむ	ラストオカルティズム ~ 現し世の秘術師	名詞
らすとおかるてぃずむ	ラストオカルティズム	名詞

ねおちくりんいんふれいむ	ネオ竹林インフレイム	名詞
おくまんごくのかね	億万劫の鐘	名詞
おかるとあとらくと	オカルトアトラクト	名詞
きょうかいふぉーくろあ	境界フォークロア	名詞
!!アンノウンX ~ Occultly Madness	非想天則より
そうぼうのくるい	相貌の狂い ~ Horrible Night	名詞
そうぼうのくるい	相貌の狂い	名詞
