あかよりあかいゆめ	赤より紅い夢	名詞
ほおずきみたいにあかいたましい	ほおずきみたいに紅い魂	名詞
ようまやこう	妖魔夜行	名詞
るーねいとえるふ	ルーネイトエルフ	名詞
おてんばこいむすめ	おてんば恋娘	名詞
しゃんはいこうちゃかん	上海紅茶館 ~ Chinese Tea	名詞
しゃんはいこうちゃかん	上海紅茶館	名詞
めいじじゅうななねんのしゃんはいありす	明治十七年の上海アリス	名詞
ヴわるまほうとしょかん	ヴワル魔法図書館	名詞
らくとがーるしょうじょみっしつ	ラクトガール ~ 少女密室	名詞
めいどとちのかいちゅうどけい	メイドと血の懐中時計	名詞
つきどけいるなだいある	月時計 ~ ルナ・ダイアル	名詞
つきどけいるなだいある	月時計	名詞
つぇぺしゅのおさなきまつえい	ツェペシュの幼き末裔	名詞
なきおおじょのためのせぷてっと	亡き王女の為のセプテット	名詞
まほうしょうじょたちのひゃくねんさい	魔法少女達の百年祭	名詞
UNおーえんはかのじょなのか？	U.N.オーエンは彼女なのか？	名詞
あかよりはかないえいえん	紅より儚い永遠	名詞
こうろう	紅楼 ~ Eastern Dream...	名詞
こうろう	紅楼	名詞
